~~~~~~~~~~~~~~ ~~ $*
~~~T~~~~~~~~~~o ~  *
***-**************T*
~~~~~~~~~~~~~~~~~~~~
~~~~~~~~~~~~~~~~~~~~
~~~~~~~~~~T ~~~~~~~~
~~~ ~~~~~~~~~~~~~~~~
~~ook~~~~~~a  ~o ~~~
~~~o ~~~~~~ ~~~ ^~~~
~~~~~~~~~~o ~~~~~~~~