********************
*^       o*   *   k*
* * *****T* * * ****
* *     *   *   **o*
* * ***o*-********T*
* * *****          *
* *     *** *    ***
* *****~~~~~******$*
*      o*a* -~~-  T*
********************