~~~~~~~~~~~~~~~~~~~~
~  ^~~~~~~~~~~~~~~~~
~a T~~~~~~~~~~~~~~~~
~~~~~~~~~~~~~~~~~~~~
~~~~~~~~~~~~~~~~~~~~
~    ~~~~~~~k     ~~
~    ~~~~~~~~~~~~~~~
*    ~~~~~~~~~~~~~~~
~    ~~~~~~~~~~~~~~~
~~~~~~~~~~~~~~~~~ ~~
~~~~~             ~~
~~~~~ o~~~~~~ ~~~~~~
~~~~~~~~~~~~ o~~~~~~
~~~~~~~~~~~~  ~~~~~~
~~~~~~~~~~~~~ ~~~~~~
~~~~~~~~ o    ~~~~~~
~~~~~~~~~~~  T~~~~~~
*-*****~~~~~~~~~~~~~
*     *~~~~~~~~~~~~~
**$T***~~~~~~~~~~~~~