$*~~**~~ T
T-~~ T~~ *
~~~~  ~~~~
~~~~  ~~~~
*T      T*
*   ^    *
~~~~  ~~~~
~~~~  ~~~~
  ~~aT~~ k
T ~~**~~ T