~~~~~~~~~~~~~~~~~~~~~~~
~~~~~~~~~~~~~~~~~~~~~~~
~~ *<* *a  * TTTTTT k~~
~~** * * *** *TTTTT  ~~
~~   * * *     TTTTTT~~
~~ *** * * * ***TTTTT~~
~~     *   *   * TTTT~~
~~**** *** * *****TTT~~
~~   *     *   *   TT~~
~~ ************* ***T~~
~~   *         *     ~~
~~** **-****** *** **~~
~~  $    *           ~~
~~~~~~~~~~~~~~~~~~~~~~~
~~~~~~~~~~~~~~~~~~~~~~~